8,8,8,8,8,8,8,8,8,8,8,8,8,8,8,8,8,8,8,8,8,8,8,8,8,8,8,8,8,8,8,8,8,8,8,8,8,8,8,8
8,12,3,0,9,1,3,1,4,3,4,1,2,1,1,0,1,0,0,0,0,3,3,0,1,0,4,2,0,2,1,4,3,4,1,3,3,1,2,8
8,1,2,0,9,1,9,9,9,9,9,9,9,9,9,9,9,9,9,9,9,9,9,9,4,9,9,9,9,9,9,9,9,9,9,9,9,9,4,8
8,1,4,2,0,3,0,9,3,3,2,0,9,3,0,1,2,9,9,9,9,9,2,9,4,9,9,9,9,9,2,2,0,9,3,1,1,9,1,8
8,9,9,9,9,9,3,9,0,9,9,9,9,1,9,9,4,9,3,4,3,3,3,9,2,2,4,2,4,9,2,9,1,9,2,9,2,9,0,8
8,3,4,3,1,3,1,9,3,1,9,4,9,0,0,3,1,9,4,9,9,9,9,9,9,9,9,9,0,9,4,9,3,9,3,9,3,9,2,8
8,1,9,9,9,9,9,9,9,1,9,0,9,1,9,9,9,9,4,9,1,3,1,1,1,2,1,9,0,9,9,9,4,9,3,9,1,9,2,8
8,2,3,0,0,2,4,4,9,3,1,2,9,3,3,1,1,1,0,9,3,1,1,4,3,4,1,9,0,4,1,4,3,9,0,9,1,9,4,8
8,9,9,9,9,9,9,0,9,9,2,9,9,0,9,9,9,9,9,9,1,4,2,12,3,4,3,9,9,9,9,9,2,9,3,9,4,9,3,8
8,0,3,2,9,1,4,2,0,3,0,4,9,3,2,0,4,3,2,9,4,4,0,3,1,0,2,9,3,4,2,4,1,9,2,9,1,9,4,8
8,3,9,3,9,1,9,9,9,9,9,0,9,9,9,9,9,9,4,9,1,2,2,4,0,4,0,9,4,9,9,9,9,9,0,9,0,9,0,8
8,2,9,1,9,2,9,0,1,1,9,1,9,0,1,4,2,9,0,9,9,9,9,9,9,9,9,9,4,9,4,2,2,9,1,9,4,9,2,8
8,1,9,0,0,3,9,2,9,0,9,2,9,2,9,9,9,9,0,3,2,4,0,9,3,2,2,1,4,9,1,9,1,9,4,9,9,9,1,8
8,1,9,9,9,9,9,0,9,0,9,3,9,1,0,2,9,9,9,9,9,9,2,9,3,9,9,9,9,9,0,9,2,9,2,0,0,0,2,8
8,0,1,1,2,3,3,4,9,0,9,0,9,0,9,1,1,3,2,4,0,0,3,9,4,9,4,1,3,9,2,9,0,9,9,9,9,9,9,8
8,9,9,9,9,9,9,2,9,9,9,4,9,9,9,1,9,9,9,9,9,9,4,4,4,9,2,9,2,9,2,9,3,9,2,1,12,0,0,8
8,4,1,3,2,0,0,3,9,1,0,0,2,1,9,1,4,1,2,3,2,9,9,9,9,9,2,9,0,9,1,9,3,9,1,2,1,1,0,8
8,1,9,9,9,9,9,9,9,2,9,9,9,9,9,9,9,0,9,9,1,2,1,0,4,0,3,9,0,9,0,9,3,9,9,9,2,9,9,8
8,1,2,1,4,0,2,4,2,0,9,4,0,3,4,4,4,0,3,9,9,9,9,9,9,9,9,9,3,0,2,9,4,2,2,2,1,3,3,8
8,8,8,8,8,8,8,8,8,8,8,8,8,8,8,8,8,8,8,8,8,8,8,8,8,8,8,8,8,8,8,8,8,8,8,8,8,8,8,8
